10,10
1111111P11
1010000101
1111101111
1000001101
1011110001
1000101011
1100110101
111M000101
M001010101
1111111111
