10,10
1111111111
1100M00001
1001110101
1010010001
1P00110011
1010011011
1111011001
1010100101
1M00000111
1111111111
