10,10
1000000001
0110100011
0001011010
0100100000
0101010110
0010010110
1010100100
0000110110
0100101010
P010M0000M
