20,20
11111111111111111111
10000000100000000001
11000100000010010101
10001000100000001001
10101110010101001001
11001110000010011001
10001110001010010001
11000010101011011101
11011P00000001010001
10011110100000000001
10000000001000010101
10010010000001100101
10010001001000100001
10010100100100001001
10000000000010010001
11010000111100000101
10000010000001000001
10000010100101010001
1M0100000000000000M1
11111111111111111111
